7
11111101111
11112001111
60000001111
11111101111
11111101112
30000050100
11100000000
11110001100
11110001110
11114000110
11111100500